13 24
XXXXXXXXXXXXXXXXXXXXXXXX
X|||+|||||||+||+|||||||X
X|--|-------#---|--.--|X
X|--+.......|---|--.--|X
X|..|-------|---#--.--|X
X|--|||||||||||||--.--|X
X|--|---.---|---|--.--|X".

X|||+|||||||+...|||||||X
X|--|-------|------|--|X
X+||||||||#|+|||#|||..|X
X|----|--.---------#---X
X||||||||||||||+||||---X
XXXXXXXXXXXXXXXXXXXXXXXX
1
T 19 9 W |